111111111	1
100000000	1
1011010$0	1
101000000	1
1010$1000	1
1010010*0	1
101111000	1
100000000	1
10*000000	1
10000*000	1
100000000	1
100000000	1
100000000	1
100000000	1
111111111	1
